[user]
	name = Tuan Tran
	email = mptnt1988@gmail.com
[core]
	editor = emacs -nw
	autocrlf = false
	whitespace = fix,indent-with-non-tab,trailing-space,cr-at-eol
[color]
	ui = auto
[color "branch"]
    current = yellow reverse
    local = yellow
    remote = green
[color "diff"]
    meta = yellow bold
    frag = magenta bold
    old = red bold
    new = green bold
    whitespace = red reverse
[color "status"]
    added = green
    changed = yellow
    header = white
    untracked = cyan
[alias]
    a = add
    st = status
    co = checkout
    br = branch
    cm = commit
    lw = log -p --word-diff
    tree = log --graph --pretty=format:'%Cred%h%Creset -%C(yellow)%d%Creset %s %Cgreen(%cr) %C(bold blue)<%an>%Creset' --abbrev-commit
    lol = log --graph --decorate --pretty=short --all --abbrev-commit
    hist = log --pretty=format:'%Cred%h %C(yellow)%d %Creset%s %C(bold blue)<%an>%Creset' --abbrev-commit --graph --date=short
[status]
	showUntrackedFiles = no
[merge]
	tool = meld
